11111111111111
1P001111C00011
100C0000000101
10111110000101
101000011100C1
10100010C00101
10000010101101
1C1000001001E1
11111111111111
