111111111111
1P0000010001
101111010C01
1000010001E1
111111111111
