111111111111
100000000001
100000000C01
100000000PE1
111111111111
