



1111111111111
1001C000000C1
10CC011111001
1CPC110EC0001
10C1C000000C1
1111111111111





