1111111111111111111111111111111111111111111111111111111111111111111111111111111111111111111111111111111111
1P0000000000000000000000000000000000000000000000000000000000000000000000000000000000000000000000000000CE01
100000000000000000000000000000000000000000000000000000000000000000000000000000000000000000000000000000C001
100000000000000000000000000000000000000000000000000000000000000000000000000000000000000000000000000000C001
100000000000000000000000000000000000000000000000000000000000000000000000000000000000000000000000000000C001
100000000000000000000000000000000000000000000000000000000000000000000000000000000000000000000000000000C001
100000000000000000000000000000000000000000000000000000000000000000000000000000000000000000000000000000C001
100000000000000000000000000000000000000000000000000000000000000000000000000000000000000000000000000000C001
100000000000000000000000000000000000000000000000000000000000000000000000000000000000000000000000000000C001
100000000000000000000000000000000000000000000000000000000000000000000000000000000000000000000000000000C001
100000000000000000000000000000000000000000000000000000000000000000000000000000000000000000000000000000C001
100000000000000000000000000000000000000000000000000000000000000000000000000000000000000000000000000000C001
100000000000000000000000000000000000000000000000000000000000000000000000000000000000000000000000000000C001
100000000000000000000000000000000000000000000000000000000000000000000000000000000000000000000000000000C001
100000000000000000000000000000000000000000000000000000000000000000000000000000000000000000000000000000C001
100000000000000000000000000000000000000000000000000000000000000000000000000000000000000000000000000000C001
100000000000000000000000000000000000000000000000000000000000000000000000000000000000000000000000000000C001
100000000000000000000000000000000000000000000000000000000000000000000000000000000000000000000000000000C001
100000000000000000000000000000000000000000000000000000000000000000000000000000000000000000000000000000C001
100000000000000000000000000000000000000000000000000000000000000000000000000000000000000000000000000000C001
100000000000000000000000000000000000000000000000000000000000000000000000000000000000000000000000000000C001
100000000000000000000000000000000000000000000000000000000000000000000000000000000000000000000000000000C001
100000000000000000000000000000000000000000000000000000000000000000000000000000000000000000000000000000C001
100000000000000000000000000000000000000000000000000000000000000000000000000000000000000000000000000000C001
100000000000000000000000000000000000000000000000000000000000000000000000000000000000000000000000000000C001
100000000000000000000000000000000000000000000000000000000000000000000000000000000000000000000000000000C001
100000000000000000000000000000000000000000000000000000000000000000000000000000000000000000000000000000C001
1111111111111111111111111111111111111111111111111111111111111111111111111111111111111111111111111111111111
