11111111111111111111111111111111111111111111111
110000000000000C0000CC00000000000C0000000C01111
101000000000000C0000CC00000000000C0000000C01111
1001E0000000000C0000CC00000000000C0000000C01111
100010000000000C0000CC00000000000C0000000C01111
100001000000000C0000CC00000000000C0000P00C01111
100000100000000C0000CC00000000000C0000000C01111
100000010000000C0000CC00000000000C0000000C01111
11111111111111111111111111111111111111111111111
